Number -> [0-9]+
Identifier -> [a-z][A-Z]_([a-z][A-Z]_)*
Variables -> variables
TypeByte -> byte
TypeWord -> word
TypeDword -> dword
TypeQword -> qword
TypeFloat -> float
TypeDouble -> double
TypePointer -> pointer
Assign -> assign
Call -> call
Ret -> ret
Br -> br
Goto -> goto
Nop -> nop
Select -> select
Add -> add
Sub -> sub
Mul -> mul
SMul -> smul
Div -> div
SDiv -> sdiv
Rem -> rem
SRem -> srem
And -> and
Or -> or
Xor -> xor
Shl -> shl
AShr -> ashr
LShr -> lshr
Not -> not
Neg -> neg
Lea -> lea
Inc -> inc
Dec -> dec
With -> with
Cz -> cz
Cnz -> cnz
Ceq -> ceq
Cne -> cne
Cgt -> cgt
Cgts -> cgts
Cge -> cge
Cges -> cges
Clt -> clt
Clts -> clts
Cle -> cle
Cles -> cles
Label -> label
Define -> define
String -> "([-"]|\.)*"
Comma -> ,
Colon -> :
LeftBracket -> [
RightBracket -> ]
Dot -> .
Comment -> #(.|' '|'\t')*

(^e: epsilon)

S -> variables code | code
type -> TypeByte | TypeWord | TypeDword | TypeQword | TypeFloat | TypeDouble | TypePointer
varDef -> LeftBracket type Comma Identifier RightBracket
_varList -> Comma varList | ^e
varList -> varDef _varList
variables -> Variables Colon varList
code -> instruction code | ^e
assignInstruction -> Assign Identifier Comma clauseInstruction
callInstruction -> Call Identifier argList
argList -> Comma factor argList | ^e
factor -> Number | Identifier | String | clauseInstruction
binOpInstruction -> binOp factor Comma factor
binOp -> And | Sub | Mul | SMul | Div | SDiv | Rem | SRem | And | Or | Xor | Shl | AShr | LShr
unOpInstruction -> unOp factor
unOp -> Not | Neg | Lea | Inc | Dec | With
selectInstruction -> Select factor Comma factor Comma factor
nopInstruction -> Nop
brInstruction -> Br factor Comma Identifier Comma Identifier
gotoInstruction -> Goto Identifier
fakeLabelInstruction -> Dot Label Identifier
fakeDefineInstruction -> Dot Define Identifier factor
fakeInstruction -> fakeLabelInstruction | fakeDefineInstruction
clauseInstruction -> LeftBracket (assignInstruction | callInstruction | binOpInstruction | unOpInstruction) RightBracket
instruction -> assignInstruction | callInstruction | nopInstruction | brInstruction | gotoInstruction | fakeInstruction